"filename", "language", "HTML", "JavaScript", "JavaScript React", "CSS", "XML", "comment", "blank", "total"
"e:\Class\大四上\web\CareFreeJourney\packages\CClient\src\assets\css\app.css", "CSS", 0, 0, 0, 2467, 0, 130, 520, 3117
"e:\Class\大四上\web\CareFreeJourney\packages\CClient\src\assets\font\iconfont.svg", "XML", 0, 0, 0, 0, 39, 3, 45, 87
"e:\Class\大四上\web\CareFreeJourney\packages\CClient\src\components\Author\Avatar.js", "JavaScript", 0, 26, 0, 0, 0, 0, 2, 28
"e:\Class\大四上\web\CareFreeJourney\packages\CClient\src\components\Author\Follow.js", "JavaScript", 0, 30, 0, 0, 0, 0, 2, 32
"e:\Class\大四上\web\CareFreeJourney\packages\CClient\src\components\Author\List.js", "JavaScript", 0, 25, 0, 0, 0, 0, 2, 27
"e:\Class\大四上\web\CareFreeJourney\packages\CClient\src\components\Author\index.js", "JavaScript", 0, 44, 0, 0, 0, 15, 6, 65
"e:\Class\大四上\web\CareFreeJourney\packages\CClient\src\components\Collect\Create.js", "JavaScript", 0, 49, 0, 0, 0, 0, 2, 51
"e:\Class\大四上\web\CareFreeJourney\packages\CClient\src\components\Collect\List.js", "JavaScript", 0, 35, 0, 0, 0, 0, 3, 38
"e:\Class\大四上\web\CareFreeJourney\packages\CClient\src\components\Collect\Switch.js", "JavaScript", 0, 19, 0, 0, 0, 0, 2, 21
"e:\Class\大四上\web\CareFreeJourney\packages\CClient\src\components\Collect\Title.js", "JavaScript", 0, 18, 0, 0, 0, 0, 2, 20
"e:\Class\大四上\web\CareFreeJourney\packages\CClient\src\components\Collect\index.js", "JavaScript", 0, 196, 0, 0, 0, 1, 19, 216
"e:\Class\大四上\web\CareFreeJourney\packages\CClient\src\components\Comment\Action.js", "JavaScript", 0, 32, 0, 0, 0, 0, 4, 36
"e:\Class\大四上\web\CareFreeJourney\packages\CClient\src\components\Comment\Author.js", "JavaScript", 0, 37, 0, 0, 0, 0, 2, 39
"e:\Class\大四上\web\CareFreeJourney\packages\CClient\src\components\Comment\Header.js", "JavaScript", 0, 24, 0, 0, 0, 0, 2, 26
"e:\Class\大四上\web\CareFreeJourney\packages\CClient\src\components\Comment\List.js", "JavaScript", 0, 37, 0, 0, 0, 0, 2, 39
"e:\Class\大四上\web\CareFreeJourney\packages\CClient\src\components\Comment\Loading.js", "JavaScript", 0, 11, 0, 0, 0, 0, 1, 12
"e:\Class\大四上\web\CareFreeJourney\packages\CClient\src\components\Comment\Text.js", "JavaScript", 0, 9, 0, 0, 0, 0, 4, 13
"e:\Class\大四上\web\CareFreeJourney\packages\CClient\src\components\Comment\Textarea.js", "JavaScript", 0, 48, 0, 0, 0, 0, 4, 52
"e:\Class\大四上\web\CareFreeJourney\packages\CClient\src\components\Comment\index.js", "JavaScript", 0, 218, 0, 0, 0, 4, 24, 246
"e:\Class\大四上\web\CareFreeJourney\packages\CClient\src\components\Events\index.js", "JavaScript", 0, 120, 0, 0, 0, 0, 11, 131
"e:\Class\大四上\web\CareFreeJourney\packages\CClient\src\components\Forward\index.js", "JavaScript", 0, 54, 0, 0, 0, 1, 3, 58
"e:\Class\大四上\web\CareFreeJourney\packages\CClient\src\components\Header\Navigation.js", "JavaScript", 0, 37, 0, 0, 0, 0, 2, 39
"e:\Class\大四上\web\CareFreeJourney\packages\CClient\src\components\Header\User\Avatar.js", "JavaScript", 0, 35, 0, 0, 0, 0, 3, 38
"e:\Class\大四上\web\CareFreeJourney\packages\CClient\src\components\Header\User\LoginRegistered.js", "JavaScript", 0, 15, 0, 0, 0, 0, 1, 16
"e:\Class\大四上\web\CareFreeJourney\packages\CClient\src\components\Header\User\Menu.js", "JavaScript", 0, 49, 0, 0, 0, 4, 3, 56
"e:\Class\大四上\web\CareFreeJourney\packages\CClient\src\components\Header\User\Message.js", "JavaScript", 0, 59, 0, 0, 0, 0, 5, 64
"e:\Class\大四上\web\CareFreeJourney\packages\CClient\src\components\Header\User\MessageList.js", "JavaScript", 0, 65, 0, 0, 0, 0, 2, 67
"e:\Class\大四上\web\CareFreeJourney\packages\CClient\src\components\Header\User\index.js", "JavaScript", 0, 25, 0, 0, 0, 0, 3, 28
"e:\Class\大四上\web\CareFreeJourney\packages\CClient\src\components\Header\Write.js", "JavaScript", 0, 36, 0, 0, 0, 0, 2, 38
"e:\Class\大四上\web\CareFreeJourney\packages\CClient\src\components\Header\index.js", "JavaScript", 0, 19, 0, 0, 0, 0, 2, 21
"e:\Class\大四上\web\CareFreeJourney\packages\CClient\src\components\Label\index.js", "JavaScript", 0, 68, 0, 0, 0, 0, 2, 70
"e:\Class\大四上\web\CareFreeJourney\packages\CClient\src\components\Modal\Message.js", "JavaScript", 0, 55, 0, 0, 0, 0, 6, 61
"e:\Class\大四上\web\CareFreeJourney\packages\CClient\src\components\Modal\click\Render.js", "JavaScript", 0, 13, 0, 0, 0, 0, 1, 14
"e:\Class\大四上\web\CareFreeJourney\packages\CClient\src\components\Modal\click\index.js", "JavaScript", 0, 30, 0, 0, 0, 0, 5, 35
"e:\Class\大四上\web\CareFreeJourney\packages\CClient\src\components\Modal\mouseover\Render.js", "JavaScript", 0, 33, 0, 0, 0, 0, 2, 35
"e:\Class\大四上\web\CareFreeJourney\packages\CClient\src\components\Modal\mouseover\index.js", "JavaScript", 0, 31, 0, 0, 0, 0, 5, 36
"e:\Class\大四上\web\CareFreeJourney\packages\CClient\src\components\Modal\remove\Portal.js", "JavaScript", 0, 26, 0, 0, 0, 2, 6, 34
"e:\Class\大四上\web\CareFreeJourney\packages\CClient\src\components\Modal\remove\index.js", "JavaScript", 0, 56, 0, 0, 0, 4, 6, 66
"e:\Class\大四上\web\CareFreeJourney\packages\CClient\src\components\Page\index.js", "JavaScript", 0, 214, 0, 0, 0, 9, 15, 238
"e:\Class\大四上\web\CareFreeJourney\packages\CClient\src\index.js", "JavaScript", 0, 14, 0, 0, 0, 0, 3, 17
"e:\Class\大四上\web\CareFreeJourney\packages\CClient\src\pages\404\index.js", "JavaScript", 0, 16, 0, 0, 0, 0, 2, 18
"e:\Class\大四上\web\CareFreeJourney\packages\CClient\src\pages\App.jsx", "JavaScript React", 0, 0, 81, 0, 0, 1, 5, 87
"e:\Class\大四上\web\CareFreeJourney\packages\CClient\src\pages\Article\Header.js", "JavaScript", 0, 60, 0, 0, 0, 0, 4, 64
"e:\Class\大四上\web\CareFreeJourney\packages\CClient\src\pages\Article\Html.js", "JavaScript", 0, 21, 0, 0, 0, 0, 2, 23
"e:\Class\大四上\web\CareFreeJourney\packages\CClient\src\pages\Article\Type.js", "JavaScript", 0, 24, 0, 0, 0, 0, 2, 26
"e:\Class\大四上\web\CareFreeJourney\packages\CClient\src\pages\Article\index.js", "JavaScript", 0, 73, 0, 0, 0, 0, 3, 76
"e:\Class\大四上\web\CareFreeJourney\packages\CClient\src\pages\Collect\Sidebar.js", "JavaScript", 0, 33, 0, 0, 0, 0, 2, 35
"e:\Class\大四上\web\CareFreeJourney\packages\CClient\src\pages\Collect\index.js", "JavaScript", 0, 65, 0, 0, 0, 0, 6, 71
"e:\Class\大四上\web\CareFreeJourney\packages\CClient\src\pages\Editor\Center.js", "JavaScript", 0, 38, 0, 0, 0, 0, 2, 40
"e:\Class\大四上\web\CareFreeJourney\packages\CClient\src\pages\Editor\Image.js", "JavaScript", 0, 53, 0, 0, 0, 7, 2, 62
"e:\Class\大四上\web\CareFreeJourney\packages\CClient\src\pages\Editor\Label.js", "JavaScript", 0, 100, 0, 0, 0, 0, 4, 104
"e:\Class\大四上\web\CareFreeJourney\packages\CClient\src\pages\Editor\Title.js", "JavaScript", 0, 33, 0, 0, 0, 0, 2, 35
"e:\Class\大四上\web\CareFreeJourney\packages\CClient\src\pages\Editor\Write.js", "JavaScript", 0, 85, 0, 0, 0, 2, 6, 93
"e:\Class\大四上\web\CareFreeJourney\packages\CClient\src\pages\Editor\index.js", "JavaScript", 0, 45, 0, 0, 0, 0, 3, 48
"e:\Class\大四上\web\CareFreeJourney\packages\CClient\src\pages\Login\Controller.jsx", "JavaScript React", 0, 0, 246, 0, 0, 3, 8, 257
"e:\Class\大四上\web\CareFreeJourney\packages\CClient\src\pages\Login\Login.js", "JavaScript", 0, 43, 0, 0, 0, 0, 2, 45
"e:\Class\大四上\web\CareFreeJourney\packages\CClient\src\pages\Login\Register.js", "JavaScript", 0, 61, 0, 0, 0, 0, 2, 63
"e:\Class\大四上\web\CareFreeJourney\packages\CClient\src\pages\Login\Submit.js", "JavaScript", 0, 110, 0, 0, 0, 2, 3, 115
"e:\Class\大四上\web\CareFreeJourney\packages\CClient\src\pages\Login\index.js", "JavaScript", 0, 32, 0, 0, 0, 0, 2, 34
"e:\Class\大四上\web\CareFreeJourney\packages\CClient\src\pages\People\Content\Article.js", "JavaScript", 0, 60, 0, 0, 0, 1, 4, 65
"e:\Class\大四上\web\CareFreeJourney\packages\CClient\src\pages\People\Content\Collect.js", "JavaScript", 0, 68, 0, 0, 0, 0, 4, 72
"e:\Class\大四上\web\CareFreeJourney\packages\CClient\src\pages\People\Content\Dynamic.js", "JavaScript", 0, 41, 0, 0, 0, 0, 3, 44
"e:\Class\大四上\web\CareFreeJourney\packages\CClient\src\pages\People\Content\Follow.js", "JavaScript", 0, 90, 0, 0, 0, 0, 7, 97
"e:\Class\大四上\web\CareFreeJourney\packages\CClient\src\pages\People\Header.js", "JavaScript", 0, 58, 0, 0, 0, 0, 2, 60
"e:\Class\大四上\web\CareFreeJourney\packages\CClient\src\pages\People\Links.js", "JavaScript", 0, 36, 0, 0, 0, 0, 2, 38
"e:\Class\大四上\web\CareFreeJourney\packages\CClient\src\pages\People\Router.js", "JavaScript", 0, 31, 0, 0, 0, 0, 2, 33
"e:\Class\大四上\web\CareFreeJourney\packages\CClient\src\pages\People\Sidebar\Achieve.js", "JavaScript", 0, 29, 0, 0, 0, 0, 2, 31
"e:\Class\大四上\web\CareFreeJourney\packages\CClient\src\pages\People\Sidebar\Follow.js", "JavaScript", 0, 29, 0, 0, 0, 0, 2, 31
"e:\Class\大四上\web\CareFreeJourney\packages\CClient\src\pages\People\Sidebar\index.js", "JavaScript", 0, 29, 0, 0, 0, 0, 3, 32
"e:\Class\大四上\web\CareFreeJourney\packages\CClient\src\pages\People\index.js", "JavaScript", 0, 72, 0, 0, 0, 0, 7, 79
"e:\Class\大四上\web\CareFreeJourney\packages\CClient\src\pages\Posts\Action.js", "JavaScript", 0, 55, 0, 0, 0, 1, 2, 58
"e:\Class\大四上\web\CareFreeJourney\packages\CClient\src\pages\Posts\Article.jsx", "JavaScript React", 0, 0, 48, 0, 0, 6, 4, 58
"e:\Class\大四上\web\CareFreeJourney\packages\CClient\src\pages\Posts\Author.js", "JavaScript", 0, 31, 0, 0, 0, 1, 2, 34
"e:\Class\大四上\web\CareFreeJourney\packages\CClient\src\pages\Posts\Html.js", "JavaScript", 0, 51, 0, 0, 0, 0, 3, 54
"e:\Class\大四上\web\CareFreeJourney\packages\CClient\src\pages\Posts\List.js", "JavaScript", 0, 31, 0, 0, 0, 1, 2, 34
"e:\Class\大四上\web\CareFreeJourney\packages\CClient\src\pages\Posts\Sidebar\Order.js", "JavaScript", 0, 32, 0, 0, 0, 0, 2, 34
"e:\Class\大四上\web\CareFreeJourney\packages\CClient\src\pages\Posts\Sidebar\Search.js", "JavaScript", 0, 56, 0, 0, 0, 0, 2, 58
"e:\Class\大四上\web\CareFreeJourney\packages\CClient\src\pages\Posts\Sidebar\index.js", "JavaScript", 0, 12, 0, 0, 0, 1, 1, 14
"e:\Class\大四上\web\CareFreeJourney\packages\CClient\src\pages\Posts\Type.js", "JavaScript", 0, 25, 0, 0, 0, 0, 2, 27
"e:\Class\大四上\web\CareFreeJourney\packages\CClient\src\pages\Posts\index.js", "JavaScript", 0, 94, 0, 0, 0, 63, 9, 166
"e:\Class\大四上\web\CareFreeJourney\packages\CClient\src\pages\Setter\Account.js", "JavaScript", 0, 57, 0, 0, 0, 0, 6, 63
"e:\Class\大四上\web\CareFreeJourney\packages\CClient\src\pages\Setter\AccountView.js", "JavaScript", 0, 34, 0, 0, 0, 70, 2, 106
"e:\Class\大四上\web\CareFreeJourney\packages\CClient\src\pages\Setter\Links.js", "JavaScript", 0, 24, 0, 0, 0, 1, 2, 27
"e:\Class\大四上\web\CareFreeJourney\packages\CClient\src\pages\Setter\Password.js", "JavaScript", 0, 36, 0, 0, 0, 0, 5, 41
"e:\Class\大四上\web\CareFreeJourney\packages\CClient\src\pages\Setter\PasswordView.js", "JavaScript", 0, 58, 0, 0, 0, 0, 4, 62
"e:\Class\大四上\web\CareFreeJourney\packages\CClient\src\pages\Setter\index.js", "JavaScript", 0, 31, 0, 0, 0, 0, 4, 35
"e:\Class\大四上\web\CareFreeJourney\packages\CClient\src\pages\Subscr\List.js", "JavaScript", 0, 47, 0, 0, 0, 0, 2, 49
"e:\Class\大四上\web\CareFreeJourney\packages\CClient\src\pages\Subscr\Search.js", "JavaScript", 0, 49, 0, 0, 0, 0, 2, 51
"e:\Class\大四上\web\CareFreeJourney\packages\CClient\src\pages\Subscr\index.js", "JavaScript", 0, 106, 0, 0, 0, 0, 6, 112
"e:\Class\大四上\web\CareFreeJourney\packages\CClient\src\pages\animate.css", "CSS", 0, 0, 0, 2375, 0, 16, 404, 2795
"e:\Class\大四上\web\CareFreeJourney\packages\CClient\src\pages\router.js", "JavaScript", 0, 19, 0, 0, 0, 0, 3, 22
"e:\Class\大四上\web\CareFreeJourney\packages\CClient\src\request\index.js", "JavaScript", 0, 121, 0, 0, 0, 0, 15, 136
"e:\Class\大四上\web\CareFreeJourney\packages\CClient\src\store\Appstore.js", "JavaScript", 0, 320, 0, 0, 0, 2, 36, 358
"e:\Class\大四上\web\CareFreeJourney\packages\CClient\src\store\Editorstore.js", "JavaScript", 0, 176, 0, 0, 0, 19, 27, 222
"e:\Class\大四上\web\CareFreeJourney\packages\CClient\src\store\Peoplestore.js", "JavaScript", 0, 167, 0, 0, 0, 0, 14, 181
"e:\Class\大四上\web\CareFreeJourney\packages\CClient\src\store\Setterstore.js", "JavaScript", 0, 109, 0, 0, 0, 0, 9, 118
"e:\Class\大四上\web\CareFreeJourney\packages\CClient\src\store\index.js", "JavaScript", 0, 10, 0, 0, 0, 0, 2, 12
"e:\Class\大四上\web\CareFreeJourney\packages\CClient\src\template\index.html", "HTML", 17, 0, 0, 0, 0, 0, 0, 17
"e:\Class\大四上\web\CareFreeJourney\packages\CClient\src\utils\index.js", "JavaScript", 0, 22, 0, 0, 0, 0, 6, 28
"Total", "-", 17, 5120, 375, 4842, 39, 370, 1414, 12177